B P B B B B B B B B B B B B B B B B B B B B B B B B B B B B
B P T T T T T T T T T T T T T T T T T T T T T T T T T T T B
S P T T T T T T T T T T T T T T T T T T T T T T T T T T T B
B P T T T P P P P P P P P P P P P P P P P P P P T T T T T B
B P T T T P G G L L G G G G G G G G G L L G G P T T T T T B
B P T T T P G G L L G G G G G G G G G L L G G P T T T T T B
B P T T T P G G G P G G G G G G G G G P G G G P T T T T T B
P P P P T P G G G P P P P P P P P P P P P P G P T T T T T B
B T T P T P G G G P G G G G G L G G P G G P G P T T T T T B
B T T P P P P P P P G G G G G L G G P G G P G P T T T T T B
B T T T T P G G G P G G G G G L G G P G G P G P T T T T T B
B T T T T P G G G P P P P P P S P P P G G P G P T T T T T B
B T T T T P G G G P G G G G G P G G G L L P G P T T T T T B
B T T T T P G G G P G G G G G P G G G L L P G P T T T T T B
B T T T T P G G G P P P P P P P P P P P P P G P T T T T T B
B T T T T P G G L L G G G G G P G G G G G G G P T T T T T B
B T T T T P G G L L G G G G G P G G G G G G G P T T T T T B
B T T T T P P P P P P P P P P P P P P P P P P P T T T T T B
B T T T T T T T T T T T T T T T T T T T T T T T T T T T T B
B B B B B B B B B B B B B B B B B B B B B B B B B B B B T B 
